                                                                                                                                               
                                                                                                                                               
                                                                                                                                               
                                                                                                                                               
                                                                                                                                               
_|_______                                                                                                                             _______|_
B|                                                                                                                                           |B
B|                                                                                                                                           |B
B|                                                                                                                                           |B
B|                                                                                                                                           |B
_|_______                 _______|_|_|_______                 _______|_|_|_______                 _______|_|_|_______                 _______|_
B|                               |B|B|                               |B|B|                               |B|B|                               |B
B|                               |B|B|                               |B|B|                               |B|B|                               |B
B|                               |B|B|                               |B|B|                               |B|B|                               |B
B|                               |B|B|                               |B|B|                               |B|B|                               |B
_|_______                 _______|_|_|_______                 _______|_|_|_______                 _______|_|_|_______                 _______|_
B|                               |B|B|                               |B|B|                               |B|B|                               |B
B|                               |B|B|                               |B|B|                               |B|B|                               |B
B|                               |B|B|                               |B|B|                               |B|B|                               |B
B|                               |B|B|                               |B|B|                               |B|B|                               |B
_|_______                 _______|_|_|_______                 _______|_|_|_______                 _______|_|_|_______                 _______|_
B|                               |B|B|                               |B|B|                               |B|B|                               |B
B|                               |B|B|                               |B|B|                               |B|B|                               |B
B|                               |B|B|                               |B|B|                               |B|B|                               |B
B|                               |B|B|                               |B|B|                               |B|B|                               |B
_|_______                 _______|_|_|_______                 _______|_|_|_______                 _______|_|_|_______                 _______|_
B|                               |B|B|                               |B|B|                               |B|B|                               |B
B|                               |B|B|                               |B|B|                               |B|B|                               |B
B|                               |B|B|                               |B|B|                               |B|B|                               |B
B|                               |B|B|                               |B|B|                               |B|B|                               |B
_|_______                 _______|_|_|_______                 _______|_|_|_______                 _______|_|_|_______                 _______|_
B|                               |B|B|                               |B|B|                               |B|B|                               |B
B|                               |B|B|                               |B|B|                               |B|B|                               |B
B|                               |B|B|                               |B|B|                               |B|B|                               |B
B|                               |B|B|                               |B|B|                               |B|B|                               |B
_|_______                 _______|_|_|_______                 _______|_|_|_______                 _______|_|_|_______                 _______|_
B|                               |B|B|                               |B|B|                               |B|B|                               |B
B|                               |B|B|                               |B|B|                               |B|B|                               |B
B|                               |B|B|                               |B|B|                               |B|B|                               |B
B|                               |B|B|                               |B|B|                               |B|B|                               |B
_|_______                 _______|_|_|_______                 _______|_|_|_______                 _______|_|_|_______                 _______|_
B|                               |B|B|                               |B|B|                               |B|B|                               |B
B|                               |B|B|                               |B|B|                               |B|B|                               |B
B|                               |B|B|                               |B|B|                               |B|B|                               |B
B|                               |B|B|                               |B|B|                               |B|B|                               |B
_|_______                 _______|_|_|_______                 _______|_|_|_______                 _______|_|_|_______                 _______|_
B|                               |B|B|                               |B|B|                               |B|B|                               |B
B|                               |B|B|                               |B|B|                               |B|B|                               |B
B|                               |B|B|                               |B|B|                               |B|B|                               |B
B|                               |B|B|                               |B|B|                               |B|B|                               |B
_|______                  _______|_|_|_______                 _______|_|_|_______                 _______|_|_|_______                 _______|_
B|                               |B|B|                               |B|B|                               |B|B|                               |B
B|                               |B|B|                               |B|B|                               |B|B|                               |B
B|                               |B|B|                               |B|B|                               |B|B|                               |B
B|                               |B|B|                               |B|B|                               |B|B|                               |B
_|_______                 _______|_|_|_______                 _______|_|_|_______                 _______|_|_|_______                 _______|_
B|                                                                                                                                           |B
B|                                                                                                                                           |B
B|                                                                                                                                           |B
B|                                                                                                                                           |B
_|_______                                                                                                                             _______|_
                                                                                                                                               
                                                                                                                                               
                                                                                                                                               
                                                                                                                                               
                                                                                                                                               