                                                                                                                                  
                                                                                                                                  
                                                                                                                                  
                                                                                                                                  
                                                                                                                                  
_______                                                                                                                    _______
                                                                                                                                  
                                                                                                                                  
                                                                                                                                  
                                                                                                                                  
_______                 _______||_______                 _______||_______                 _______||_______                 _______
                               ||                               ||                               ||                               
                               ||                               ||                               ||                               
                               ||                               ||                               ||                               
                               ||                               ||                               ||                               
_______                 _______||_______                 _______||_______                 _______||_______                 _______
                               ||                               ||                               ||                               
                               ||                               ||                               ||                               
                               ||                               ||                               ||                               
                               ||                               ||                               ||                               
_______                 _______||_______                 _______||_______                 _______||_______                 _______
                               ||                               ||                               ||                               
                               ||                               ||                               ||                               
                               ||                               ||                               ||                               
                               ||                               ||                               ||                               
_______                 _______||_______                 _______||_______                 _______||_______                 _______
                               ||                               ||                               ||                               
                               ||                               ||                               ||                               
                               ||                               ||                               ||                               
                               ||                               ||                               ||                               
_______                 _______||_______                 _______||_______                 _______||_______                 _______
                               ||                               ||                               ||                               
                               ||                               ||                               ||                               
                               ||                               ||                               ||                               
                               ||                               ||                               ||                               
_______                 _______||_______                 _______||_______                 _______||_______                 _______
                               ||                               ||                               ||                               
                               ||                               ||                               ||                               
                               ||                               ||                               ||                               
                               ||                               ||                               ||                               
_______                 _______||_______                 _______||_______                 _______||_______                 _______
                               ||                               ||                               ||                               
                               ||                               ||                               ||                               
                               ||                               ||                               ||                               
                               ||                               ||                               ||                               
_______                 _______||_______                 _______||_______                 _______||_______                 _______
                               ||                               ||                               ||                               
                               ||                               ||                               ||                               
                               ||                               ||                               ||                               
                               ||                               ||                               ||                               
______                  _______||_______                 _______||_______                 _______||_______                 _______
                               ||                               ||                               ||                               
                               ||                               ||                               ||                               
                               ||                               ||                               ||                               
                               ||                               ||                               ||                               
_______                 _______||_______                 _______||_______                 _______||_______                 _______
                               ||                               ||                               ||                               
                                                                                                                                  
                                                                                                                                  
                                                                                                                                  
_______                                                                                                                    _______
                                                                                                                                  
                                                                                                                                  
                                                                                                                                  
                                                                                                                                  
                                                                                                                                  
