                                                                                                                                               
                                                                                                                                               
                                                                                                                                               
                                                                                                                                               
                                                                                                                                               
_|_______                                                                                                                             _______|_
G|                                                                                                                                           |G
G|                                                                                                                                           |G
G|                                                                                                                                           |G
G|                                                                                                                                           |G
_|_______                 _______|_|_|_______                 _______|_|_|_______                 _______|_|_|_______                 _______|_
G|                               |G|G|                               |G|G|                               |G|G|                               |G
G|                               |G|G|                               |G|G|                               |G|G|                               |G
G|                               |G|G|                               |G|G|                               |G|G|                               |G
G|                               |G|G|                               |G|G|                               |G|G|                               |G
_|_______                 _______|_|_|_______                 _______|_|_|_______                 _______|_|_|_______                 _______|_
G|                               |G|G|                               |G|G|                               |G|G|                               |G
G|                               |G|G|                               |G|G|                               |G|G|                               |G
G|                               |G|G|                               |G|G|                               |G|G|                               |G
G|                               |G|G|                               |G|G|                               |G|G|                               |G
_|_______                 _______|_|_|_______                 _______|_|_|_______                 _______|_|_|_______                 _______|_
G|                               |G|G|                               |G|G|                               |G|G|                               |G
G|                               |G|G|                               |G|G|                               |G|G|                               |G
G|                               |G|G|                               |G|G|                               |G|G|                               |G
G|                               |G|G|                               |G|G|                               |G|G|                               |G
_|_______                 _______|_|_|_______                 _______|_|_|_______                 _______|_|_|_______                 _______|_
G|                               |G|G|                               |G|G|                               |G|G|                               |G
G|                               |G|G|                               |G|G|                               |G|G|                               |G
G|                               |G|G|                               |G|G|                               |G|G|                               |G
G|                               |G|G|                               |G|G|                               |G|G|                               |G
_|_______                 _______|_|_|_______                 _______|_|_|_______                 _______|_|_|_______                 _______|_
G|                               |G|G|                               |G|G|                               |G|G|                               |G
G|                               |G|G|                               |G|G|                               |G|G|                               |G
G|                               |G|G|                               |G|G|                               |G|G|                               |G
G|                               |G|G|                               |G|G|                               |G|G|                               |G
_|_______                 _______|_|_|_______                 _______|_|_|_______                 _______|_|_|_______                 _______|_
G|                               |G|G|                               |G|G|                               |G|G|                               |G
G|                               |G|G|                               |G|G|                               |G|G|                               |G
G|                               |G|G|                               |G|G|                               |G|G|                               |G
G|                               |G|G|                               |G|G|                               |G|G|                               |G
_|_______                 _______|_|_|_______                 _______|_|_|_______                 _______|_|_|_______                 _______|_
G|                               |G|G|                               |G|G|                               |G|G|                               |G
G|                               |G|G|                               |G|G|                               |G|G|                               |G
G|                               |G|G|                               |G|G|                               |G|G|                               |G
G|                               |G|G|                               |G|G|                               |G|G|                               |G
_|_______                 _______|_|_|_______                 _______|_|_|_______                 _______|_|_|_______                 _______|_
G|                               |G|G|                               |G|G|                               |G|G|                               |G
G|                               |G|G|                               |G|G|                               |G|G|                               |G
G|                               |G|G|                               |G|G|                               |G|G|                               |G
G|                               |G|G|                               |G|G|                               |G|G|                               |G
_|______                  _______|_|_|_______                 _______|_|_|_______                 _______|_|_|_______                 _______|_
G|                               |G|G|                               |G|G|                               |G|G|                               |G
G|                               |G|G|                               |G|G|                               |G|G|                               |G
G|                               |G|G|                               |G|G|                               |G|G|                               |G
G|                               |G|G|                               |G|G|                               |G|G|                               |G
_|_______                 _______|_|_|_______                 _______|_|_|_______                 _______|_|_|_______                 _______|_
G|                                                                                                                                           |G
G|                                                                                                                                           |G
G|                                                                                                                                           |G
G|                                                                                                                                           |G
_|_______                                                                                                                             _______|_
                                                                                                                                               
                                                                                                                                               
                                                                                                                                               
                                                                                                                                               
                                                                                                                                               